#############
#··········P#
#·###########
#···········#                             ###
###########·###############################··#
          #····································#
###########··············GR····················#
#···········###############################··#
#·###########                             ###
#···········#
#############
