#########
#·····#·#
#·#·P···#
#·##·##·#
#·······#
#·#   #·#
#·#GBR#·#
#·#####·#
#···#···#
#·#···#·#
#########