#########
#·····#·#
#·#·P···#
#·##·##·#
#·······#
#·#   #·#
#·#   #·#
#·#####·#
#··R#··G#
#·#···#·#
#########