#########
#·····#·#
#·#·P···#
#·##·##·#
#·······#
#·## ##·#
#·#GGG#·#
#·#####·#
#···#···#
#·#···#·#
#########