#########
#     # #
# # P·  #
# ## ## #
#       #
# #   # #
# #G R# #
# ##### #
#   #   #
# #   # #
#########